HHHHHHHHHH
RRRRRRRRRR
HHRHHHHHHH
HHRHHHHHHH
HHRRRRRRRR
HHHHHRHHHH