HRHHHHHHRH
HRHRRRRHRH
HRHRHHRHRH
HRRRHHRRRH
HHHRHHHHHH